NO ./sims.xpm
SO ./sims.xpm
WE ./sims.xpm
EA ./sims.xpm
F 0,255,0
C 0,0,255
111111111111111111111111
100000000110000000000011
10N000000000000110000001
100000000111100001000001
100010000000000000000001
100010000000000000111001
100001111100000011110001
111111111111111111111111
