EA ./textures/green_hill2.xpm

NO ./textures/zelda1.xpm

SO ./textures/green_hill1.xpm

C 0,0,255         

WE ./textures/zelda2.xpm

C 0,0,255 

111111111111111111111111
100000000110000000000011
100000000000000110000001
100000000111100001000001
100010000000000000000001
100010000000000000111001
10E001111100000011110001
111111111111111111111111
