EA ./textures/white_bricks.xpm

NO ./textures/bricks.xpm

SO ./textures/bricks.xpm

C 255,255,191         

WE ./textures/white_bricks.xpm

F 158,20,30 

11111111111111111111111111111111111111111111111111111111111111111111111111111111
1E100000000000000000000000000000000001111110100000000000000000000000000000000001
10100000000100000000011110000000100001111110100000000100000000011110000000100001
10010000010000111111100000000000100001111110010000010000111111100000000000100001
10011100101000100000000011111100100001111110011100101000100000000011111100100001
10000001000100101111000000000111100001111110000001000100101111000000000111100001
10110000000000000000000000000000000001111110110000000000000000000000000000000001
11111111111111111111111111110111111111111111111111101111111111111111111111111111
                    11111111011111111111111111111110111111
                    10000000010000000000000001000000000001
                    10001000010001111111111100000000000001
                    10011111110000000000000001110111000001
                    10000000010000010000000001000010000001
                    10011111111111110000111111000011111101
                    10000000000000000000000001000000000001
                    11111111111111111111111111111111111111