EA ./textures/oulu.xpm

NO ./textures/oulu2.xpm

SO ./textures/oulu2.xpm

C 255,255,191        

WE ./textures/oulu.xpm

F 158,20,30 

1111111111111111111111111111111111111111111111              1111111111111111111111111111111111111111
1000000000000000000000000000000000000000000001              1000000000000000000000000000000000000001
1000100000000N00111111111000000000001000000001              1000110000000110011000000011001100010001
1000000000000000000000000000000000000100000001              1000110000000110011100000011001100100001
1000000100000000000000001111100000000010000001              1000110000000110011010000011001101000001
1001000000000000000000000000110100000001110001 11111  1111  1000110000000110011001000011001110000001
1000000100001111100000100000000000000000000101110001111001111000110000000110011000100011001110000001
1010000000000000000000100000000100000000000000000000000000000000110000000110011000010011001101000001
1010000000000000000000100000000100000000000000000000000000000000111111100110011000001011001100100001
1000111111100000000000100000000000000000000001110001111001111000111111100110011000000111001100010001
1000000000000000000000100000000000111100000001 11111  1111  1000000000000000000100000000000000000001
1010000000100000000000000000000000000000000001              1000000000000000001110000000000000000001
1001000001010000001111111110000000000000000001              1000000000000000010010000000000000000001
1000100010000000000000000000000000011110000001              1000000000000000111111000000000000000001
1000011100000000011111100000000000000000000001              1111111111111111111111111111111111111111
1000000000000000000000000000000000000011100001
1111111111111111111111111111111111111111111111