EA ./textures/oulu.xpm

NO ./textures/oulu2.xpm

SO ./textures/bricks.xpm

C 0,0,255         

WE ./textures/white_bricks.xpm

F 92,64,51 

111111111111111111111111111111111111111111111111111111111111
111110000000011100000000000000011111110011100000000000001111
1111100000S0011100000000111000001111110011100111000000001111
111110011111111100111100111001100111110011100111001111111111
111110011111111100111100111001110011110011100111001111111111
111110000000011100111100111001111001110011100111001111111111
111110000000011100111100111001111100110011100111001111111111
111111111110011100111100111001111110010011100111001111111111
111111111110011100111100111001111111000011100111001111111111
111110000000011100000000111001111111100011100111000000001111
111110000000000000000000111001111111110000000111000000001111
111111111111111111111111111111111111111111111111111111111111 